121111111111
805333333333331
14777777771
1888888888881
19999999991
111111111111
1111111111111111111111111