1111111111111111111111
10000000000000000000 1
1111111000000000111111111111111
11000000000000000000000000001
11111111111111111111111111111