1111111
10000091
1N22221
1000001
1111111