111111111111
100000000001
100000040001
100000050001
100000000001
111111111111