111111111111
12222222222221
13333333333331
14444444444444444444441
155555555555555555555551
111111111111