111111111111
100000000001
100000000001
144444444441
195555555551
111111111111