111111111111
10000001
10001
10001
10000001
111111111111
1111111111111111111111111