NO ./imgs/cub.xpm
SO ./imgs/cub.xpm
WE ./imgs/cub.xpm
EA ./imgs/cub.xpm

F 21,96,43
C 148,210,255

111111111111
100000000001
100000000001
100000000001
100000000001
100W00000001
100000000001
111111111111