NO ./imgs/wall.xpm
SO ./imgs/floor.xpm
WE ./imgs/soil.xpm
EA ./imgs/ston.xpm

F 21,96,43
C 148,210,255


     1111111111111111111111111
    1000000000110000000000001
   1011000001110000000000001
  1001000000000000000000001
11111111101100000111000001
10000000001100000111011111111
11110111111111011100000010001
11110111111111011101010010001
11000000110101011100000010001
10000000000000001100000010001
10000000000000001101010010001
11000001110101011111011110N01
11110111 1110101 101111010001
11111111 1111111 111111111111